A = A‚ù§Ô∏è  
B = B‚ù§Ô∏è  
C = C‚ù§Ô∏è  
√á = √á‚ù§Ô∏è  
D = D‚ù§Ô∏è  
E = ‰πá‚ù§Ô∏è  
F = F‚ù§Ô∏è  
G = G‚ù§Ô∏è  
ƒû = ‡´≠‚ù§Ô∏è  
H = H‚ù§Ô∏è  
I = I‚ù§Ô∏è  
ƒ∞ = ƒ∞‚ù§Ô∏è  
J = j‚ù§Ô∏è  
K = k‚ù§Ô∏è  
L = L‚ù§Ô∏è  
M = M‚ù§Ô∏è  
N = N‚ù§Ô∏è  
O = ooo‚ù§Ô∏è  
√ñ = √ñ‚ù§Ô∏è  
P = ùìü‚ù§Ô∏è  
R = R‚ù§Ô∏è  
S = S‚ù§Ô∏è  
≈û = ≈û‚ù§Ô∏è  
T = T‚ù§Ô∏è  
U = „Äúu„Äú‚ù§Ô∏è  
√ú = √ú‚ù§Ô∏è  
V = V‚ù§Ô∏è  
Y = Y‚ù§Ô∏è  
Z = z‚ù§Ô∏è  
Q = Q‚ù§Ô∏è  
W = W‚ù§Ô∏è  
X = X‚ù§Ô∏è  
. = .
 =   
