A = A🍎  
B = B💣  
C = C🌈  
Ç = Ç💎  
D = D🔥  
E = 乇🕊️  
F = F❄️  
G = G🌿  
Ğ = ૭🐛  
H = H🌤️  
I = I🌙  
İ = İ✨  
J = j🎷  
K = k⚔️  
L = L🪞  
M = M🌙  
N = N🎵  
O = o🎃  
Ö = Ö🌼  
P = 𝓟🎀  
R = R⚡  
S = S🌪️  
Ş = Ş🌫️  
T = T🛡️  
U = 〜u〜🌊  
Ü = Ü💧  
V = V🎮  
Y = Y🕊️  
Z = z🦋  
Q = Q🖤  
W = W👑  
X = X🔮  
